bind: pads promise side it woman end him itself anything them himself cloth
close: hand inns Gap door eyes IV gate shutter them feet shutters work
rule: Kings
call: life Men yourselves word Lord me dogs twenties folk people ourselves Phial demand ’em Nanduhirion Death land leaf it end ship everything Gollum Entwood Dernhelm what himself Sam vulgar those Brandir strength Ring victory wall seat names sun Farewell trilogy joy everyone eagle Frodo heart you Ents yourself whom themselves whatever her myself all ´ which Holbytlan Whither peace us hom Hollin ’s him Bundushathuˆr name head Gondor them Ithil nothing Company
publish: Prolegomena Study Unwin edition Father article editions Books
experience: mistakes
try: me pace they falls prize notes teeth mouth count sequence times all spurt he something him glimpse victims window mind events impression task ﬂy features feet himself swaps spells horse bowshot distances heart you yourself entrance song us them Bilbo Sme´agol gate thoughts cover southwards spell part end marshes door troubles steps sounds itself words tree master claim ber sword enemy it items accounts barrier what Nazguˆl Shelob Ring tricks Frodo hold courage her memory Shire way
say: man boat inhabitants breath indoors me dearer Halfelven way A farewell sheath ﬁnger beacons ring stick hand foes deceives deal story Faramir monster TI Wormtongue times Road plough Ents presents Dwarf all years Daeron Caves he Fool darkness something meal this him Doors Lords days companions parting anyone things face singing hope laughter wits liar masters time hobbit east ruin hilts stone welcome fairer doubts affairs realm gem himself tidings grace Pippin men anything laugh dwelleth you Hall battle Cı´rdan eye whatever ´ Dwarves reproach- us them I movements body bottles Saruman thing son Lord r letter skill gang What steed thoughts light southwards King Blindfold part Meriadoc Eldar water luggage Gollum n. care door favour oath words birthday staves wrath Eomer head Lady shadow fool naught day nothing truth one word counsel folk Sun any sword death we bit it voices n’t coming aught Boromir what Radagast hobbits taste shadows Ring companion power Hallo rider loss Frodo business root lad armouries kingsfoil her courage memory Shire Orcs bank ’s name chant nay trees
impede: appreciation
have: bundle fame another RNE roots colour hobbitry that truck apron earth bark use servants guide story carts delight times reason powers Ents legs grass reference virtue errand meal trouble month Helm weaknesses lack News opener morrow mind helm Stones pony friends task plants come,1 honour horses tidings joy ships shelter fuel men dwellings food eye ´ edges quiver entrance source job I control sorrows Men history voice week skill air mines secret gang indexing Stone holes mastery Legolas opinions mile Aragorn friendship everything promise This those troubles weed recall farms bodies words struggle enemies nonsense idea houses Andu´ril objection quality house dealings counsel bones anxiety lembas we date rumour shock scratch what taste duties Ring weapon power provision lots ORD readers front which wisdom name rays ’’ followers plan Pimple allies dominion stuff council halt sort language weapons clubs halls wall dwarf advice ing this him corslet love foresight distance pains hobbit joke reign knife comfort heaps virtues doubts terror cleft stairs duty woodcraft trust you nest government pocket hole us feelings force beauty tankard end someone call sight risk skin lands foreboding blood peace Strider style day journey purpose ﬁght questions value chapters wounds none badger fright trace voices pouch aught Summerdays gifts Gimli discussions seat war crown ﬁve business orders courage ropes her memory view Orcs choices keys price cat wit speech teeth beacons devil some mistrust sons hat store deal rival notion others all potency blades Bill lot guard glimpse sound knowledge life anyone things beliefs hope messages wits swords borders custom relations night uniforms clothes heir HES drink windows ground snow child horse miles bench chapter poison supper stockings dream blade strength them deed hair glooms wife wash ﬁngers light signiﬁcance shame choice part Elfstone bottom Gollum account ideas marshes treasures Sam names boots favour councils bowmen hauberk head chair naught refuge cargo hood pity labels ﬂed word doors fortune beer sword bit tower Mountains ship ears path wood pipes road charges fun vulture Business effect sheen pipe dainties trees way passion eyes axes me songs spears storey tyeller conscience interest Which deﬁnitions parapet Water gauntlets captain beard tussle aid letters years sleep watchers creatures something burns days lunch companions calls wings ﬁnd tokens time news collar club glance witness dangers stone whip rope dance feet star cloak phaunts chance nap sense anything secrets heart Council titles H desire tales Bree adventures basis thing relation attempt What dwelling papers supply toes audience breakfast gift dark depart reputation dinner hearts rings vision tale barbs horsemen labour shot wink patience roof hour despair madman coat nothing packs ways matters folk any enemy numbers friend leaf it reasons n’t melodies smell entertainment scent meanings victory cloaks packet Keys point Mountain hands spare walls ’s Whatever soles shields
unreveale: information
contain: instruments letters her index hitherto records part diphthong mesh us letter days vowel information
receive: ﬁght thing wound me Morgul sword news copies it annotation gift crown sceptre you guests aid letters this name him corslet summons them weight
make: inquiries piles mincemeat imprint songs ridge noise sign raids bends paths speech effort Counsellors plans use search shift story deal haste varieties others mistake mistakes years sleep riders loop meal him minds movement bill track things assault reply wards shores alliance swords impression scroll dash land year home bridges line Tolkien friends mischief havoc efforts chase caves lights Pippin men you thaw lane hole bay Dwarves H song errors catalogue amends them mail Men week edition Saruman Lord answers Speech secret attempt What place lists dwelling legends delays light ones camp jargons choice heed part breakfast end pools tube gardens friendship problem those names marks westwards boots boats ﬂood tale headway words pile ﬁgure calculations Gate imitation net enemies tongues peace Lady service refuge journey nothing house ways arrangements folk penny bivouac bonﬁre beds difference it shape smell path shapes Rangers what trial landings road rush revel historians Ring war fun Warden valley evil bargain decision which corrections goods journeys Sauron way defence mess pillow
enter: Wood voice Tirith Mirkwood password Muil Naith land expanse it Cardolan Battle Fellowship City deﬁle Eriador Door hand praise shadows Guldur Forest gates Mordor Gate Moria Mines Shire guile circle service Vale
reset: book Fellowship
include: variations corrections members glimpses misrepresentations words land number
appear: chief hoods time friends rebel VI language strangers what himself Osgiliath lems boats bowmen crown turret Merry lane name them nothing
set: eyes fellows me chain dogs host jewel pavilions banner effort teeth trumpeters fume ring webs some hand wall Merry image all potency bowl he table guard him towers spear ﬂames wings tooth Queen arm Stones mantle stone backs sail himself servant revision pillar chance fern men you food riddles bane us venom errors blade them movements East thing rune score steel Meriadoc Isildur course barriers marks lands Mordor spies fortress foot Crown circlet ourselves circlets sword pans it voices keeper ripples barrier arrow what seat Ring ﬁres crown ORD hands Frodo themselves her which watchmen shoulder puzzle heavens traps shields
replace: him them trees helm foreword
add: item food things dimensions touches index word spirit revisions gift wonder version weakness what
record: Hobbits changes copies
work: things ways jewel tools ruin it mischief inwards ﬁtting those Merry Jewels image all errors us Arwen them wonder
find: man yourselves breath me sign plains host stair way jewel ledge ring creature work weapons people Faramir reason truesilver something this guard him rooms days sustenance vigour movement sheaths things time ford stone wizard home reminiscences friends bed creek bag corners himself Guesthouse horses ground chance spring men you bay entrance errors us stream passage them strength thing Sme´agol pen cluster place traces King Legolas Elves Aragorn shore Gollum Sam door treasures steps gates ﬂood words pile woman places nothing mark barrels none shinbone any sword enemy stature it trace dell path Boromir what road ponies Ring power evil themselves her myself desert links which name trees
send: greetings calls Men Peregrin south messengers word prisoners Nob me thing son messages Himself penny roots army messenger Isen beams number ambassadors archers Elrond it voices Elves ship Calenardhon shaft beating duty people shiver huntsmen Ring tidings lash bowmen captain Faramir message men words cries Ents you soldiers Frodo scouts aid ´ Orcs corrections something stream this company him Eowyn force them marching jets navy
fail: things notes Sam which me us Dunlendings him woods time earth Gollum
force: northwards ravine knees myself it thing entrance us feet limbs way Freca path them appendices self
bear: man scar me stool fruit misfortune device rod spikes trunks weapons casket Faramir bucklers riders something him summons things load ﬂames staff hope hobbit news stone children gem lights tidings horse notice you slabs us Hand them strength body signs title cluster southwards horn Legolas cup Him sight names blossom boats lands shards torches daughters Andu´ril weight coat hither torch dale folk none stars it Boromir arrow what scent Ring weapon Steward arms badges badge her which raiment name
cause: needs suspicion deal
attempt: Rohan which inconsistency this evil them panies nothing work
leave: Wind garrison lips Tirith eyes me host council mouth ring earth Erebor some work hand people Rohan cliff wall chamber Road whom Angle streams rien clamour washing all Bill trouble table this him woods mushrooms Vale ash messages Hoarwell land home friends hint mischief affairs night chip horses Galen drink Pippin leisure message anything men child print you dwellings city food orphan us Mirror River deﬁcit Bree them reward control village footprints gate book place pools roads everything Gollum Hobbiton Isildur hill world marks Gate Buckland Eomer Orthanc strongholds houses party fool chair Annuˆn pool mark Brandybucks house bushes End balcony counsel bridle kin thread folk barrow any Rivendell friend top river it Downs City pelts Lothlo´rien limbs Dunharrow path Boromir wood what road side hills standing packet Guard tains Frodo Moria sill mountains her Chetwood which Shire woodlands name trees Company
retain: dedications appearance names speech integrity
offset: edition
involve: Hobbits process
maintain: thence custom havens posts bowmen friendship armies integrity exiles
give: advantage boot gasp dab me sign panions page stuff Shadowfax sheath berth interest signal sample sort ring list gollum use parties hand praise sion region wafer Mark Samwise advice slip aid errand exclamations chorus something trouble lot him pennies glimpse protection minds love Translations life beam surety feast hope messages Thra´in time news sport glance knife year affairs row task bed chase bag himself Hope shivers shriek attention kingdom tidings chance message ale shudder you battle dwell food ´ freshener us neigh tales them abuse strength Star forms reward attack letter understanding title What com- light supply horn choice heed Calenardhon example call cup water gift daughter wave Sting Sam names lands rings crust judgement Galadriel minute music pipeful sceptre struggle imitation cry peace idea party nothing pity ﬂed End word counsel value folk ourselves none fragrance bit belts number it gold surprise smell Evening Boromir arrow what scent satisfaction Ring description mine belt power yawn valley ORD coney orders inspiration themselves Sharkey conduct which name creeps Book way keys
cover: mounds eyes archers it globe ears Nu´menor windows lands chamber trail hands jewels evolution ´ hole us him them
write: Peregrin Lord runes book it return poetry Isildur story drafts message characters Thrimich hands letters treatise memory epilogue name ﬁrst
decribe: method
use: inside eyes bang me they language ring arrows stick hand deﬁnitions Westron Tower travellers Road legs others these trouble him sound things Quendi runes wits paddle commons time knife aids rope script grief pencil horses stem men characters uncle you Hall form hole winter nearer H us River tales them I Men soil voice week gate Speech Stone edge languages gift names Forest sounds Gate master patrols tongues glass writing dweller service s style house word tongue it nose terms surprise expression v path what road Ring power valley infusion Du´nedain lots Frodo hands magician modiﬁcation Torog elf which name sources way Entwives
signify: what
show: mark things Harad blue me instances signs hope sign bedrooms paces shield jewel line it nose spirit path what himself Whips road development misgivings lights world mercy Ring favour ground gates gear spaces you yourself themselves map wisdom us head him them way nothing
see: boat Tirith picture sign Ithildin Hob colour Barrows banner Lockholes note use Osgiliath Riders peril Thengel powers Ents whom grass heap Mithril groves darkness descent dad Swan woods shimmering Watchers R Thra´in process helm stumps glory friends leagues Battle Anor Hobbit Ciryandil Aman lights horses lines Ancalagon Northfarthing ships men Palantı´r eye lane ´ shimmer stream job forms Men Laurelin spelling meeting Eorl Nimrodel thoughts Stone holes Faithful anguish Folk Orofarne¨ Eldar knots Aragorn curling everything Dı´nen nightfall Unescapable world those door weed passim mendacil words master retreat prospect Underhill sails Elendil Ship ﬂame Arnor E sky tail house king Guthla´f Naith Rivendell waste stars Tale Telperion nose ﬂicker ripples Boromir shapes what side peaks Ring Baggins Nori Du´nedain ORD Merethrond chimney myself which Eowyn glint name Grange huddle Celerdain whither Telemnar Ondoher Woodhall Galadhon Lo´rien ring arrows Prince halls wall motionless Darkness Sea pride language(s Hithlain rien Daeron Caves riders delta Birds towers him torment minds branches Battles tears hobbit companies land Dale Marshes knife Runes sunlight Burrows you Hall wayfarers hole Dwarves bird us Bridge Star Bilbo Erkenbrand tumult Saruman son gate likeness place Ghaˆn- Ships Crebain shoulders end lanterns fords Sneak roads gap Hobbiton sight Goldwine Hador Kings lords ﬁgure ﬁgures tree Winterﬁlth Doriath Eomer Strider Atanatar Lady glimmer pastures coomb War Tree Variags Nameless MapsWorks wounds Phial none cloud river aught Whitfoot barrier Flammifer Shelob roofs glinting Smial(s scars Bumpkin her Athelas images woodlands Orcs Bane man Quenya Echor Orc blur beacons creature some trunks crash Dales eastwards Crack(s deal marvels varieties travellers rivals others all Fool Bill circle glimpse riding Landroval anyone things hurts combat Elven hope Towers swords Lebennin Gorhendad hilts home breeze caves waterways Door tenderness rest channel horse Palantir lamps print mass strife Siriondil Mithrandir wreckage River Durthang Khand them East captains beasts Gelin Doom silver signs Speech smiths Glo´in Watcher light Pass choice heed part pools Lindon strangers Gollum lakes ﬁelds Sam Lugdush course names mirage garden itself ages Rose Anduin Orthanc Everholt Buckland torches depths Arod shadow hue head family Elendilmir messengers gleam doors Smials Eresse¨a sword Citadel tower Mountains Elrond difference ship wights Lothlo´rien Eye toys path ravine grey wood road Lamedon belt arms Frodo Danger Narya bowls brow Shire goods points glimmering Ithil trees way mess Company twinkle eyes me Morgul ﬂashes host Muil pain Caradhras March wheel Elfhelm Gardner mouth hand foolishness Gift Houses specks Water Southerner Meneldil Tower Road Moors Elanor watchers creatures clatter something fellow Gate(s slopes 831–5 11–12 glitter Bard movement Stonebows Bombadil tokens forest Chief phial Waymeet Erelas line masks Bucca bed Eagles feet log glare star spring anything Bucklebury Council chasm Beorn character Rings mill Stair Bree Wood Nenya Peregrin footprints ﬂoods thing Lord book markings Chamber What Elves curtains Shadow Forlong Minhiriath pieces Hills waters vision Dunlendings II dome 340–1 scratches visions roof Horn obstacle Curunı´r winters HA stones nothing House Crown folk any phantoms Lu´thien Reckoning it shape Celebdil morning twilight Aduˆ De´agol Guards cloaks point Mountain hands Pelennor Corsairs wonder Ingold
wear: yourselves face tunic silver swords What jewel helm mantle shirt Legolas it night shoes ring feet hat Ring belt dwarf crown cloaks you effect Narya this them way mail hood
consider: people it enquiries journey message These romance you direction
drop: stone them fish head epilogue him Baggins branch ﬂowers quarrel sword
share: yours it which wafer bewilderment trouble blindness
comment: errors
correct: me errors hope
introduce: cirth alterations errors innovation him
issue: light Fellowship calendar nigh command them orders
read: admittance things letter signs book copy desires it matter what some passages people marks hearts text riddle policies words letters these memory author them
notice: man form it imprint which differences him arrival whom nothing
compile: lists
follow: order Hobbits press Bywater plan counsel me mufﬂed pony wizard Shadowfax noon Legolas it friends Company example marshal Quickbeam Aragorn path This road course lights westwards Faramir trail Frodo you others master enemies her Mithrandir Orcs us leader stream this River him gaze instruction company them companions way day Ea¨rnil track
weary: him
cease: yells function names it wind hour power dignity him ancies ward might
enjoy: yourselves part story joke chances yourself
seem: man breath eyes me pace Morgul noise sign they way disc storm ledge treachery that selves dim note sort language earth tide bark hand Riders halls eastwards centre deal sun story record Road Ents whom midst grass guests letters all sleep years he horns something lot guard rock him branches doubt doorway lack sound court sea things face wind ﬂames window surface distance feast messages time person change conspiracy arm land stone rear friends steam dance noses kind ﬁtting fall feet grief gem himself leaves tidings ground Pippin anything Deep notice heart you miles skirts senses chapter lane winter us passage them opportunity mail Bilbo stillness voice answer skill thing attempts air Lord silver fellowship title book round boughs place lists giants heads ﬁngers legends Faithful light languages horn affection Elves part call water crouch Aragorn Inn awe sight level blocks Sam dread world names course hearts steps hundreds gates tale meaning words ladder ﬁgure cries blood wains ringing waybread Inside enemies tongues roof accord wells depths peace amount leader echo fouler refuge day bustle nothing truth sky house dealings confusion king word thought matters hastiness tongue Ted sword stand numbers beds stature Enemy it vanishment who City limbs ears path wood matter steeds what scent size side moment war fun power arms valley evil guardroom resistance point Frodo hands business effect mountains her which Shire Orcs name fears corner Sauron trees direction Company
develop: Noldor which folk forms lists talent
investigate: variations
distinguish: dwelling what voices tween
compare: colons
change: house purpose plan me thoughts it voices ship jacket course chance workmen habits form fortunes us name hue him manner quality
intend: it emphasis he vowels fern evil English poss- you what
hew: blast man Riders body it servant neck head Arrow him Forlong iron wood legs
require: it value correction union time words
want: Took word air me ﬁnd problems book outsiders gaffer time What any news ’em deeds open land rights bit Elrond Underhills it slaves Lockholes herbs baggage water ring strangers everything what information clothes Shelob Sam Butterbur string Ring fun deal companion Baggins Bucklebury anything Frodo you coney master advice mountains Merry supper sleep food Gandalf he Shire country Orcs investigator him party them mushrooms I keys openers reward truth
not: ﬁrmness Saruman skill eyes thing faults problems swords tools land it terror everything wood grit shadows Ring power Mordor heart you legs Anduin dwellings faith wisdom song us him them strength way nothing
prepare: them road edge funeral which darkness this him armament time volume everything way you
explain: expeditions names it
explore: length dell ground conﬁnes inﬂuences
interest: him you me readers
enhance: enjoyment
become: heirlooms excavation attack king Morgul messages sign tongue Orc exiles connexions dangers reminiscences it voices Elves part shape fruit relations water path West friendship attention Ring war Mordor you themselves all enemies Shire Easterlings head him glimpses days
precede: them nasal it
wish: order life man things voice anyone Holdwine Saruman eyes Lord me Quest counsel another journey fortune swords What enemy Rivendell death piece light friend greatness that glory home it friends who City night water everything grief what treasure people magic lights troubles Ring horses Fangorn ﬁsh war Steward joy Rohirrim Frodo hands you Moria whom master ANNOUNCEMENT advice riddles he which Shire Orcs us Treebeard something him Sauron them might
take: boat bundle breath prisoners eyes me pace noise another paths spoil Shadowfax globe interest bread Which language hours vittles abode creature some rod hand weapons credit work hat peril Osgiliath store wall region deal Faramir horseman gear ofﬁce Road Ents whom others advice Merry years sleep all meal lot fellow this him days Wall morsel ﬁfty each things Hornburg staff hope tokens paddle time beast phial hobbit arm land knife stone fruits weeks masks It rebel rope bed morsels armour realm gem himself clothes sniff ease ﬁsh management bearer bore cloak drink vengeance chance Pippin These ale horse sticks anything blanket Oin you men heart food form ´ eye ma us Bolger candle passage Andros them hall strength Brandybuck mail envelope Men body lamp thing spoons air son Sme´agol wife book title place ball Stone arrangement Edoras heed end part husbands Paths cup water Aragorn roads shore everything depart Age Sting gatekeepers This Sam course names steps risk boats wives authority passim oath tale words Gate sceptre art master share staves draughts leader hour head naught refuge knives places day journey hood king counsel feathers tongue Phial strides command sword enemy Oath = mug Elrond marries it ship shape who surprise husband path ravine wood Umbar what northwards road marches Shelob pleasure Ring mine Guldur weapon power companion crown hook provision point Frodo tea hands ORD root axe lad her o memory which view Orcs name harm corner Ithil way rays
desire: likenesses order pity things Tirith thing counsel me Suˆl bond speech healing death marriage it queen wealth ring what will Gimli hills seat day power you whatever Gandalf something this him way love nothing
reveal: culmination Elrond names purposes yourself itself strength what shards land
get: breath indoors eyes claws plan me waggon prey stuff ring arrows some hand weapons Water Cracks gear couple Lugbu´rz supplies others inns sleep watchers something company this him glimpse anyone things wind room hope hobbit time news dash pony stone plenty It rope bed fainter caves guts feet himself move shriek ﬁsh chance sense message anything shutter topsides you chapter food poison grist us them blade I votes Bilbo control ﬁrst beasts bottles thing gil What holes touches Elves breakfast water everything Gollum sight information Sam boats mills stories crust tale grip enemies wink peace glass country idea dusk party Lumpkin Outsiders coat nothing truth tail house ways sacks hoods ourselves none death numbers bit friend it ears grey what provisions apples ponies Ring lash arms crown ORD hands chances Frodo lesson kingsfoil myself which name scheme
absorb: me
increase: restlessness danger end reans wits Age others track
reach: Pelargir Tirith me ridge plains stair Fords frost height eaves cliff wall region crest rien him minds sea Street Hornburg Fire tunnel borders levels home Ferry stairs feet summit ground Naur shelter Deep havens heart parts city hole chieftain entrance us River them Bree gate stage choice end Dragon bottom roads Hobbiton hill door westwards crosses causeway tree Gate angle Anduin amount mounds house foot doors bridge strip Rivendell Enemy river it archway City ears Nu´menor road Ford side Erech hills crown arms valley conﬁnes point Mountain her which Shire Hollin lawn trees
come: man eyes me ridge songs litters sign they eve whither paths host Fairbairns waterfall pavilions piece selves ﬁnger slaves dim desolation belch Weathertop knee creature hand weapons hat store wall speed dwarf Faramir trees powers Road all ice riders darkness horns table this him towers days ash kingship things shimmering wind ﬂames Himself runes alliance rain news club arm land east ford evils friends feet backs himself Cotton west furlong tidings ground Pippin message anything Bolg lamps you yourself skirts footmen city ´ nearer us wreckage force Stair them strength I Bree Men Ringwraiths madness answer voice ﬂoods son air fumes silver gate aﬁeld What dwelling heads beams holes Faithful gloom gong Elves end part conclave water cup thither rufﬁans slope Gollum gap Hobbiton sight Shadows4 door course those names steps hearts causeway gates trail drafts tale words eagle tree threshold throat Rose cry faith head ﬂame coat pool truth doom mounds ways End word questions gleam Crown folk bridge feathers Bandobras tongue ﬂats none enemy coasts Mountains Elrond it voices path Boromir rumour shapes wood what shock Nazguˆl road moment Ring Frodo ORD hands Neck space themselves standard her myself Elladan Orcs name corner journeys Ithil way keys Company
stop: man ﬁght eyes air it friends voices bonds ears moment hearts arms drafts exclamation hands master hole us Shirrifﬁng speaker head him job chant them your
like: anyone things Bywater word axes air songs hero me they secret book reminder heights place news ’em none stars bit that it Elves sup who breakfast Fimbrethil bed smell birds strangers dark Gollum what guide Forest story valley tale anything you whom reference books supper Gandalf which Shire country pipe something us fellow him woods Hand them talk nothing
hold: boat assembly breath eyes me forces wheel council liege ring rod hand weapons departure peril wafer inns Merry crevices bowl him champion things spear staff feast hope phial land bridges lids whip prisoner ﬂaw terror neck himself star attention horses ground horse men you Dwarves candle Rings blade them frontier thing meeting theory horn conclave fords promise depart door belief sceptre enemies roof torches hosts refuge house Glamdring coins folk bridge tongue Phial sword enemy deceit shirt Elrond it vambrace arrow passages road moment Ring harp power crown evil debate point ORD hands kings themselves her which gaze pipe bank menace way shields
review: it
ﬁnd: house room spot window thing me tracks doors Thra´in defects land waste fear it trace friends someone task thief Shadow keeper ring path use what some clothes Ford marshes Ring Sea gates shelter anything words Mountain Frodo thousands you yourself run documents guests master aid food Orthanc peace us something him them way Bridge nothing
pass: thence lips me songs chain sign plains Greyﬂood circuit sward paths Fords Isen throng slaves earth count hours hand wall trees others years these errand openings reans him days court things wind R wardens alliance Towers news borders east land stone year bridges line steam rope night stairs Door west Silverlode windows ground sense anything you Hall city nearer opening us River Isle them Bridge test tumult skill vigilance Gates signs gate place southwards light noon camp Legolas part end roads everything Gollum slope hill Shadows4 door boats causeway gates waters tale Gate ward Rapids Anduin ﬁles forests shadow Teeth HA nothing mounds doors bridge shred fortresses turies stars Enemy it City road northwards side ponies shadows hills valley Frodo ORD hands Neck mountains her front Orcs bank oak glimmering way
note: v eyes interest others
put: bundle maker me chain roots stuff ring mouth hand gear others Elanor all these something this him knowledge things mind box swords arm helm bag feet himself cloak mirth screen lump neath miles heart you yourself us them strength Brandybuck ﬁrst beasts skill thing aﬁeld holes shoulders end spell quarrel roads Gollum This names buds houses cap head weight hood tail grain foot word thought enemy succession mug claw garments it arrow Ring belt arms Frodo hands ORD ropes name
throw: packs things Saruman staff me enemy Stone knife weight light garments it fruit call plans grey himself weapons side door balance dust gates trees fuel gear ORD you themselves ﬂame which walls head him them helmet branches mail hood
settle: it choice foot affairs him sense rufﬁans Frodo himself dwellings
begin: me pace noise they pavilions hunt ownership mist temper forces interest canopy desolation belch ring earth hand search eastwards speed story grass streams agents errand he darkness murmur meal back something slopes him trouble days Gondor manner queer life sequels excavation face wind wards surface rabbits ruin Fields wizard rule line preparations doubts overﬂow night terror realm West ﬂy summit Eriador himself leaves bearer communities ground march anything havens you eye Dwarves nearer song us solitude chill stream passage them strength I Bilbo ﬁrst voice ear answer thing spot gil What place Faithful light southwards affection regions lord dark slope thickets Hobbiton reputation gasps hundreds loads stories lands wedges Greenway tale music Mordor tune ward labour art dominions enemies Gandalf strongholds country dusk Bounders ﬂame journey sky truth End folk lives tongue strides missiles phantoms works we spirits fro it Downs shape ankle ravine matter shapes what vation side shadows Ring valley ﬁve Frodo hands themselves which Shire Orcs goods walls gaze ’s name trees Company
resemble: those names war survival brother ﬁgures
inspire: development
direct: development assault me
dislike: things staff allegory you Bilbo
prefer: frowns languages history it end hillsides lands sixes
overlap: movements
suppose: watch road ’’ names anything time sizes some
reﬂect: situation
ﬁnishe: that those it breakfast story us tale question
build: Brandybucks boat Men house pyres ﬂoats pillars tower ship eyries rampart refuges hedge hill railways forefathers wall windows power Tower themselves enemies which us houses towers places navy
name: it Elves Hobbit people those hills names guest Tinu´viel Wormtongue Baggins you whom beard themselves hour him them day
raise: man king eyes staff shield sword banner it whip himself sight hand alarm Riders hands outwards standard inch her which Shire country head him branches
answer: calls voice questions me question Elrond it reasons Elves fainter Forlong Aragorn strangers Gollum himself some Nazguˆl Glorﬁndel Sam attention names Ha´ma challenge garden Frodo cries others Merry letters Eomer Strider him summons them appendices talk queen
offer: pity things state hope sword it choice Foreword services what foes chance shelter anything resistance tea you pence pint him service protection way
derive: adventure things
possess: it Ring thing Undying grade gh wings rings folk u book wealth him ourselves ring them what treasure
love: Wood beasts house me plains tongue hobbit beast sword land sels friend it lord Eldar earth feet daughter himself Him magic ease horses war Faramir men father you whom mountains all Dwarves her Shire Orcs despair us shadow River him tales them spies trees freedom
avoid: Barrows peril farm us touch shadow him sake land glance sight
study: books magic it signs histories matter arts
render: Cotman magic it
dwindle: southwards H them feet nothing
surpass: gold hopes gems days characters whom
deal: blow him gifts characters
dress: queer shoes fashion
laugh: me hobbit ﬁngers comrade it himself pipes hand thighs Uglu´k Ring fun Pippin bowls something head him them Bilbo
speak: mark foeman basin word eyes air Gildor me Speech sign password tongue speech thoughts piece comfort light edge languages Legolas it voices leagues choice purposes language gift ill what himself hand leaves praise Uglu´k Silverlode wall captain evil words Frodo heart you whom dialect enchantment form all creatures something name him torchlight them hair adventures truth
preserve: knowledge light glory records likeness
linger: voice ways steps banks tomb east
cross: boat Baranduin distance bridge Greyﬂood Fords Isen borders land Marshes river Mountains it fords bed water fens path Loudwater Lune ﬁelds road Ford prints Water travellers Road rivers Anduin Poros Redhorn mountains ´ rents theirs Carnen country stream River them Bridge
be: man thence answer south eyes opener hope book neek silence tower it voices grandmother come,1 ears stairs roads wood himself hill hand ﬁshes road west those door bump seat war victory communities E ground servant garden men Frodo hands you badge inns whatever head name him drizzle remnants them hair settlement day
spare: hand each years share myself communities me trouble him any time ordeal them you
learn: Quenya things history answers messages folk tongue speech news trick crafts it choice part thither what names power secrets heart father Anduin error letters all something lot this him tales them sorcery love nothing truth
keep: eyes me dogs Fairbairns eyelids folks traveller ring hours some Riders deal he creatures company dainty table guard him remnants knowledge things hope glance stone custom cow dog feet himself trap men you foothold eye nearer us River them strength Bridge heirlooms thing gate arch What thoughts runners Elves part water strangers promise those boats trail words head family style order herds word doors oaths connexions laws it Eye arrow shapes what Ring power arms loveliness hands thorns courage memory which wisdom harm way
speed: watchfulness messengers forces ships stair them you Landroval
acknowledge: her lordship authority farmers
turn: boat eyes me spears stair Shadowfax hand hat peril eastwards motionless trees Road Ents all darkness chorus something rock horns him sap minds borders east glance hilts stone pony comfort home incantation swifter amazement bed backs pursuers west joy you battle lane opening us them blade pale fellowship place thoughts southwards edge light course steps hearts boats Rohirrim Gate ward yours nonsense Strider head shadow ﬂame knives day tail word balcony thought kin sword belts leaf it nose prow path arrow grey malice road scarlet northwards unrest arms exclamation her gaze name shoulder corner way sheds
reckon: Men line it lids speed Shire day men roads them hands you what ﬁrst
end: them raid light mounds world things it song Thain name debate Muil woods return none Age Du´nedain realm
choose: house Tirith me fellowship wits paths What person place Woodhall forayers elders selves archers it friends ship fact lord night Evening kind path what himself stick people course Thain companion stewards horse dagger men Mordor you total view cap head him mortality Stair way ends
ply: them whips business
heed: world tongues it wrath H sign him command words them
shelter: it
route: them Gollum invasion
grow: life indoors wings me ourselves phantoms Death borders stumps camp gayer it shape dim fume fainter earth grey apples himself some sight sail people misty weed sun lands foal trees sense tree grass milder her graves nearer which bank chill name him currents head lot ﬁerce them strength stones places E track
raven: milder
ishe: those
know: whither pace me allies histories speech selves hours Riders peril deal story trees reason gear whom letters he blades creatures darkness something hers this lot him lack warriors knowledge link life things Watchers hope time news Death ments land countries mischief danger mists kind grief willows message anything secrets you yourself parts crossing ´ desire Ferny song us River tales rebellion Stair them strength captains Bilbo history voice skill thing son answers round deeds What thoughts languages part Rumble roads ﬁelds sight This dir names risk hundreds lands words tune master hour naught nothing fashion ways king word counsel thread copy tongue any enemy number bit it aught rumour what side companion power evil tricks Frodo ORD business themselves her myself which Shire view name ’s journeys way
kill: himself Strider me us Orcs Faramir another him Chief men arrow Gollum you yourself creature nothing
doughty: arms
handle: it boats arms head him
live: homage languages enemies friends horses prisoners end son skill lives friendship forms earth
believe: them things Dwarves descendant it eyes word me story tales fool Gondor forms Frodo land ruin
feel: eyes pace pain expectancy mist sort language ﬂakes hand peril wall speed sun deal challenge sleep darkness something reluctance him currents life wind mind rain home surge terror himself presence ground leap joy sense anything heart you Pu´kel whatever desire throb us entrance chill certainty them forms strength sink air touch evening light fear gong dread hearts words inclination waybread wrath hour shadow fool fouler weight nothing truth pity anxiety command tremor lessen thrill it City limbs Eye shock what malice Ring power tenseness weariness hands cleave themselves watchfulness her myself approach walls way sister Company
oblige: them road End foot they forms some
construct: versions
favour: millers provisions
occupy: Men Buckland which ring Gondor
forsake: it Ring alliance earth companions
dwelt: earth Elves whom approach
regard: it boats hobbit them some
swim: River boats
belong: each who him devices himself
alter: names Ring arrangements them devices day
improve: view devices tempers
surround: origin strangers them it
play: ﬁddle part hero diddle tree trick game
quote: Brandybuck
claim: man Enemy that lordship it errand victory us descent hoard crown amends everything ORD settlement page Ea¨rnil
convince: audience me
bring: boat prisoners eyes me they pain forces fruit birds devilry treasure Faramir delight gear aid all sleep warrior something trouble him Arwen parting toy things animal engines hope messages rabbits money rain box news ruin hatchet clothes horses tidings Pippin joy Arkenstone message blanket horse men you food us them Men voice bottles thing ram ’em healing Ranger light Elves end part fullness Kingdom cup gift Gollum tory Isildur treasures Noldor sire shards enemies trains torches kindlings places coat journey doom word helmets counsel gleam Sun beer sword enemy mementoes triumph it rumour steeds what gifts comments companion crown evil candles provision Pilgrim ORD lad bowls thongs her memory which name salver messenger
ﬂourishe: E
esteem: warrior it
allow: halts Shadowfax credit history selves it peace us River Sun Mordor him oftener Bree Gate hours you himself
manage: Watch promise door it affairs this while neck others hands journey
tend: beasts her duˆn it king houses garden generations Frodo you glades
attribute: laws
portend: what
guard: it Ring eyes Elves ﬂank hoard gates night him realm Fords Rangers
concern: Men history Ring Elves me us ancestry Boromir Frodo yourself himself seekers
assail: coasts fear it strongholds Orcs us fords him host Gondor them you makil Company
happen: road Orcs End birthday
lose: thing whither thread time heads temper it part territories count hours what scent sight hand horses mine lands charm power delight sense trail horse men words heart ages dwellings caution all her belongings patience which ing us company goods him them way Entwives
paddle: them boat feet
eat: king thing roots any stone it meat fruit morning breakfasts bread ﬁshes pieces passages Sam world Some ﬁsh ENS cloaks men anything you food waybread supper share which us meal him them Tom nothing
catch: rays things voice bundle breath Sme´agol me gleam ’em any glance ruin light it hint echoes sunlight malice glare himself sight De´agol names ﬁsh peaks Forest sun vision Pippin words Frodo you master ´ Gandalf which orcs Orcs us something glimmer glint him glimpses name branch glimpse sidelong them chill mufﬂed ﬂash
strangle: him it
attack: camp house enemies Hedge ﬂeets besiegers it men Gondor them inn enemy horde Bilbo
serve: man Enemy purpose Thengel Lord cups needs Eowyn him Power Whom command them none you whom himself master
challenge: king him Bilbo
ask: anyone thing questions me Captains folk Barliman question grufﬂy number it landlord Erestor Aragorn Boromir what tions hobbits hand Sam names riddle Pippin trail Frodo lads you ORD Merry advice whatever riddles Eomer us something this him them nothing
guess: gate tokens What thoughts messenger nature number that agony it part Aragorn use what creature himself arrows trap some course troubles chance you yard food ´ all poison riddles which something him summons them depth truth
defeat: Men Enemy eyes us Easterlings him Wainriders army them enemy malice invaders
do: deed things both foot thing matters justice me injury time What storm cloud trick land trickses discourtesy bit farewell it mischief n’t Fredegar task bed hatred ill earth duty what himself work This clothes murder shift Bucklander deal power howling bidding evil anything lots ORD Council you miles homage whatever all lass he which trespass us something lot this darkness harm Whatever him service job trouble them refuge I Bilbo nothing ﬁrst
lead: assault thence wards me north host pony end Eothe´od his path Gollum what creature level ponies door people hills horses survivors boats hundreds Pippin men Bolg Frodo ORD you thousands Merry yando front us Bill company him force them way Company
accept: them supper it terms correction invitation challenge morsels water service ofﬁce promise
win: Enemy crossings Dwarves it eastwards war danger victory store Battle him wealth respect Gate game battle beds
demand: advice guesses halt Frodo signatures
press: Neck Enemy breath seat it me us Frodo him ears ORD you himself
fear: Ringwraiths eyes word Lord window Nine Chamber What none death treachery it danger Elves end plunge what Riders Sam those world shadows Ring weapon dignity memory him them knives
ﬂed: Bane ´ themselves enemies war luck songs Lord him thither them pieces
slip: hand themselves boot hole it memory ﬁnger Ring cords Orcs us table Pippin him ring them knife
crouch: him belly
tempt: Ring him us
stay: hand boat elders friends indoors wrath it me pace march him nothing child movements you
hate: Saruman me What place news it height everything sunlight Bagginses himself work Rohan mine whom business city possessors which us this him them Bilbo pool
tell: man knowledge things thence ways purpose Sme´agol me chief league ’em thoughts news difference signiﬁcance Onodrim it Ent direction part ee Eldar Beregond everything Gollum what some names duties tidings story stories deal captain tale horse anything Du´nedain Frodo ORD you Questioner nobody others Council yourself Rose all her Sharkey which us Bolger something this source him tales them I Bilbo nothing truth
promise: food that master Eomer Master HES me him events times them you what talk work
disbelieve: story
hear: both breath me songs noise sign speech slaughter whinny hubbub kinds story deal Faramir travellers all sleep speeches ing murmur something this slopes him woods tinkle slam whisperings sound things calls singing proofs laughter tramp time news sigh patter scraping feet rustle himself tidings whispers horse anything you noises remonstrance song us chill Isle tales rumble them movements shiftings tread voice groan rumblings thing answers shout What thudding whispering horn Legolas crowing Elves bell water Aragorn ter reputation Sam world names stories tale words cries echo splendour naught nothing doom word beat thud command hoofs thunder bit it voices rumour what rush Steward swirl ORD trumpeting kingsfoil her which name Woses
continue: grace Chieftains debate ring assaults Gondor hunt journey
strain: them eyes friendship
think: blade things voice messengers bundle breath skill thing me intentions Gamgees stair What thoughts Reign bit that line it spell sup pat herbs birds mouth what wave ﬁelds information hand world dread wall Ring hundreds boats deal times ﬂattery words point Frodo ORD you anything loss rider 278–9 all whatever these memory troll he something this head him harm name tales them nothing truth
discover: land trace servants outlets me signs way bodies secrets roads powers prize reason what truth
save: life moonlight things voice wind king eyes Sindar Quest songs me tramp mice Aldor time pain hobbit Legolas it slaves melodies Aragorn himself those hills Guards Ring casket lines Faramir Frodo you jewels inns her he Shire creatures us trouble name him quarter fugitives them branches Bilbo
awaken: malice evil interest
collect: interest lot
ﬁlle: bottles basin room air me feast bridge mugs serpent enemy it dell slaves sight vision valley channel heart wonder themselves bowls her pages which riders Mirror us him them strength pool sky
state: Barahir
discuss: it relation pleasures journeys question
deserve: life attention thing end another thanks promise death
obtain: life Ring grace which information
visit: Shelob Room it which Shire Elves Bill Gaffer him places them ORD you Bilbo
seek: room me doors chain allies What place sword healing land Enemy glory it end Heir Paths realm Aragorn secrecy arrows what Havens words you aid ´ her rents he this him them refuge way
go: advantage boat bundle dab indoors eyes pace me whither dogs sign they paces chief paths jewel Caradhras makin farewell Stoningland council globe arrows use some hand people Grey guards deal Faramir delight trees Road legs soldiers presents others perils all sleep darkness something trouble this ters him cavalry towers lunch brother Landroval track queer things wind wards staff ﬁnd hope messages cones nigh Thra´in tunnel rain time news east land ruin yell revenge home Ferry friends swifter leagues bed night stairs himself ﬁshes balance west lights attention horses tidings HES chance skins Pippin child anything men Deep Oin you yourself miles supper hole quiver coneys entrance us cut stream chill River song them strength I Bilbo answer Peregrin thing air letter fellowship look What ’em place healing panies score southwards camp light King horn Elves bottom RS inwards anybody water mile orc beggar thither L Gollum slope account promise Hobbiton rufﬁans trumpet Sam door course westwards steps lands foreboding trail oath tumbling ward Anduin Redhorn wrath Gandalf draughts country torches head party Halﬂings refuge stones Land talk journey nothing sky tail mounds End word shirts doors bones refreshment bridge Sun beats Phial sword gale death numbers number loft Mountains Elrond it voices ship bog path Boromir grey perforce matter what road ponies side hills moment Ring war candles Guard case Frodo ORD business Neck mountains themselves myself memory Shire Orcs name points journeys Silmaril way keys mess
celebrate: birthday parties
shake: hand fear slinker it faith stones hearts air bones head pursuit him ears boughs way heads himself ﬁst
vote: admirers fellow
adopt: Frodo Speech Kings
dash: him yourself
travel: Road life Hobbiton
help: Saruman king me Isen- ourselfs question it choice friends peoples rumour Frodo you Holman master myself us him them brother revolt
carry: boat assault body load spear son pig Orc pans ones it friends faggot law what Sam homes boats hundreds deal gear pile Frodo you cudgel us torches goods him corner them weight
’s: eye villain it thing buck name place
beat: light attack it wings me height him ’em airs feet Bilbo sound master
’: pity ﬁne voice wind thing plan calling me songs wits time hobbit place news ’em any friend shame it prisoner Dragon bed terror neck Gollum marvel use what trap groping murderer mine Plain Gaffer sense Baggins anything Rosie tone ORD Gate business orders mistake all her he yonder nonsense view farm something song this glass harm him job name Strider way day talk nothing
drownde: child
push: them it himself waggons table crack him chair Sauron Orc neck ward shutters
pull: wallet house her it Ring word him himself
order: Merry packs assault goings rows us gates folk him realm them Ents you
look: man breath eyes me sign pain glances banner birds work hand praise story marvels gladder Ents others crevices something lot him brother things Watchers hurts brows hobbit land bridges friends leagues duty tenderness west troop Pippin ships anything courts lamps ´ us them silver signs bony heads Stone Shirriffs southwards spell pat Hill Rumble thither ness pieces westwards Thain meaning rainbow wrath glass nuncle head hue pastures party ﬁst nothing fashion word gleam chapters ourselves Phial Eresse¨a sword phantoms number it gold shape path what northwards roofs war arms troth which way
bless: hither weather it me him days you
produce: basket heir him bag what pipes
hope: yourselves distance longwise they Rivendell Barrows river it part orc curling path what some rest victory deceives men notice heart you thousands business aid letters memory Gandalf which fort this him woods glimpse way
mark: them ﬂight brethren it word spot fact posts orcs letter place Road you F.A.
draw: blade boat things madness breath king foot son chain nigh signs host swords phial sword tables veil knife light forces it knoll Swordsman inwards Eye curtains water terriﬁc plans Aragorn grey Sting himself cloth hand level attention cloak heir Ring skin boats lines power knot Pippin snow itself horse men lots Frodo ORD ladder hands chairs elf nearer Eomer blades glass us head ters him Andu´ril them strength knives hood
drive: wind son refuge me bulk fumes folk another paddle hunger Bandobras Rider host rain sword enemy Wulf east knife ruin it ship wretches Power corners Wainriders what himself hand Riders boats evil Council you legs horde enemies Carnen orcs Corsairs us hosts chill remnants him guard them brother
glow: sword shadows nasturtians
need: order man things voice skill thing questions counsel matters me thought hope ourselves beast What any shinbone news none ﬁngers pony light hearers fear it gold Moot endurance gardens sight will weapons Gimli Ring speed boats Boss companion arms haste medicine trail men fuel gear words hands you advice food map all sleep arguments something company guidance name him trouble lot holiday minds them strength coat defence
mean: man things captives plan offence son me arrangements mind ma´thm evening What Lobelia Chasm i land it exile danger who partings bed Aragorn ring what himself Riders people the Ring region Forest stories anything break Road Ents you Isengard supper whatever myself sleep Lotho which Shire stop us something fellow this him harm Whatever rebellion way
roll: mug doom hearts globe fruit waters table Hill him River beats boom shores them wan himself nothing
watch: man madness me place land stars light Enemy it roads Boromir turn road rings trail Road Frodo you rise master rescue her Buckland us him torchlight ﬂights days morsel them nothing
pretend: he what Business notes
overlook: existence doors accident him ﬂats them
matter: what accident
meet: Oakenshield doom I. eyes thing word me companies any Imrahil additions stone friend Shadowfax it danger end someone Beregond Aragorn barrier Gollum what Radagast Glorﬁndel side foes trail beater you whom soul master whatever enemies gaze us hers Lasgalen him them trees captains nothing
design: him
let: yelp me time sigh holes river it toes part fall lights cloak names war chance Bree ladder Road Ents you others horns guard name him them your trees
open: bundle ways eyes word non gate sign password southwards mouths it shape pouch inwards limbs mouth ﬂowers barrier grey road slit door casket war gates heart ´ eye them coomb keys
shape: stone themselves course it itself plans jewel
spout: ﬂames
duck: faces
fall: ash envelope madness ﬂed face king eyes spot word me sign host sword question numbers edge notes expanse whip it row fords sort territories feet himself hobbits side star dew Ring victory diphthongs sun ground turf channel men Du´nedain lots lamps heart Frodo legs dome faces Captain blast ﬁghting knees ´ her us grasp head River him victims them stones day sky
detest: Frodo
specialize: reputation
expect: attack answer me feast pain any number it Denethor night ﬁll bite what sight those cloak weed turf you Gandalf Strider us something Treebeard this him weight Bilbo
dread: hours what ﬁgures speech
deplete: stocks
sip: XP water beer
nibble: XP it
forget: Hobbits things history Peregrin Saruman eyes Bombadil me smiths horror sword Barrow arrangement Marshes it Elves danger manners grief wiles peril troubles horses duties war power grievance men anything words point descendants miles you whom heart orders XP ´ warrior her all wrath which errand desire hour royalty grandson this name River service him them
shout: man Uglu´k it breath corsairs soldier arms Pippin him serpent hobbit messenger Frodo others
repeat: all it which challenge him words Bilbo
agree: Deputy names this misfortune dale
blow: yourselves wind air north trumpets horn it voices fanfare dim call scent trumpet door rings Pippin cloaks candles cries hoots ORD blast horns chill sky
prick: ears sky
regret: I foolishness it
remove: light House house ﬂame those earth it west bandage splinter ring words them feet hither herdfolk
cloud: wits
sit: man hilt chin questions eyes thing me word paces beast sword ball trick Glo´in Edoras Ferry it Master voices It shape adventures musing thither L wood himself hand road ponies rups motionless Ho tenseness arms tale pleasures 278–9 heart legs sceptre guests waybread themselves all her Eomer wisdom meal head this Arwen him judgements tales corslet them day nothing
ignore: Merry questions
drain: mug bowls bowl glass cup
ﬁngere: gold frowning doors ring
fasten: waist Sting them brooch
hang: hand it roof darkness chain circle head River cloaks remnants ale sword ﬁgures
seal: lips those it
address: them hobbit it
stick: hand it Ring nose harm job pin you root
startle: them him me voice
ﬁnish: it ﬁsh task book job
badger: me
bother: me weekday companion him you
owe: knowledge weregild shapes something
trust: anyone Sam her Some it landlord swine Master myself me us meeting him them lads way you weight
wonder: things Sam her friends it story talks head him sort Aragorn reason what himself
shrug: shoulders
spoil: joke ground
start: son me ridge roots sword glance it mischief zags world those avalanche hole which leader ARK company affair Bilbo
pick: stone shirt lilies hair it shears steps ﬁnd him bag trail corner shield Frodo way sheaths stick shields
deliver: heirlooms kingdom it us shards you
jerk: head envelope
stoop: stone foreheads ´ it himself eyes brow head water strip blade ﬁgure feet knife
seize: doors tokens spears sword Edoras it lord Umbar feet hand Ring provinces chance Pippin sceptre you throat which him them
long: which untroubling immensity hands what
trot: deal rhyme path
glance: rail it window shape hands
’ll: breakfast difﬁcult feast water ring inn use
exclaim: Frodo Sam Aragorn
barrow: those
welcome: friend all it ﬁght friends Saruman callers Mithrandir company him them Frodo beauty you guests
lay: doom body slab Quest paddle comrades swords Orc sword helm waste herself it friends ﬁnger ship plans Boromir grey himself cloth hand weapons Riders turves hearts vulture cloaks men fuel couches hands father siege master mound themselves image Dwarves Renowned head pits him cloven them nothing
forgave: Bilbo
retire: friend
snap: messengers ﬁngers
escort: me her
relieve: her Legolas glinting
shut: light themselves door mouths it eyes clung window view doors them key
knock: things it me sign them heads holes
excite: hope
overcome: Merry anyone king wrath Shire Lord me joy Sancho splinter them doubt you invaders
forgive: length myself me us him jest them you
curdle: me milk
pester: him
beg: me him bread them you master
accuse: you me
walk: mounds ways wind eyes north longwise they stars top it leagues heed morning Aragorn path strangers earth wave road Sam side world hills west war OW ground chance maps men Frodo rise master knees lane her woodman shimmer which forests him nothing
refuse: food Sam fear it thing staff him mourning anything Boromir Stone master
snow: food
wander: southwards purposeless herds westwards Shire me River him rooms roads masterless himself you
approach: nasals wall him age swords places
befall: river her country us me lord him them Bilbo
gather: things Ringwraiths breath cones folk host stores news herself forces it water armies himself Nazguˆl handful speed power men Rohirrim pile grass beard themselves all which darkness him Rings force them strength stones
run: face wind ﬂames time healing gown southwards it leagues errands everything slope hill hand sight road door purposeless Silverlode standing steps carts Pippin channel terraces words cries Frodo throat space kingsfoil help walls chill slopes him head corner newcomer them way East sound
retort: Sam
daresay: him Sam you
invent: stories
had: potent OW
score: point land it
wave: hand southwards tail hat east arms him hands arm
sail: bit river selves ship Sea towers Anduin
return: tribute eyes son chief circuit news glance horn friends doubts it interest thither promise hand road Sam tidings servant Road you which Shire gaze him tales ﬁerce morsel them companions
line: them road rings
smoke: band weapon pipe rings them
break: man things spear foot thing staff me eyes fellowship doors Gates bridge command swords speech Silver rules portion silence defences it voices inwards Thangorodrim1 law stick side Ring Steward power tryst ORD heart shards necks ﬂame darkness Rule him corner boom passage them strength way
dare: der post eyes doors stair land wizard it water roads himself road peril war palantı´r message anything shafts words hands Rapids axe orders myself us this him woods Annuˆn them I ﬁrst
die: life king son Quest line Paths Boromir wood world purposeless motionless ORD Wolf ´ enemies peace head him them Tree
rule: themselves which grandmother City us Rings Stewards Rohirrim Gondor them whom others
devour: springs Riders all seat him them
shrink: ﬁnger side hall
expand: ﬁnger
warn: scouts care me us Ecthelion folk Pippin him them you
resent: it
consult: him Saruman
resist: attack temptation Rhudaur power Rings him Sauron
mention: it Ring Strider bones Bagginses journey
unfasten: Ring it
hand: it pouch me goods keys
touch: me chain arm frost leaf it eyelids water knots knee earth creature hand weapons stem ground rings anything heart you yours perils Lhaw brow which him them
grope: stone west thing me him corner way brooch
stand: man breath eyes me pace another sign paces Fords Caradhras blur archers cliffs deﬁed fume Prince hand eaves cliff wall motionless sun legs Merry weather horns guard him manner animal nigh stone she stairs himself turn chance Pippin men you Barazinbar ´ us self breastwork them hall force voice lamp leg air King fear column ﬁrm hedge door names steps words eagle buds tree ﬁgure sceptre Eomer houses Freca splendour E nothing ﬁre sky band word sword aisle tower Mountains it voices archway shape ears rumour ponies moment Frodo kings mountains themselves desert name trees
utter: which
lack: Ring thing men anything
hide: things eyes traces light bit it friends fact shape rufﬁans treasure himself some hills Ring heart jewels themselves brightness which us shoulder reeks them
sully: them
ensnare: them Sauron
recover: mastery it word strength nothing
command: it servants view Mirror me bits whom thee Warden him men them wing you land
destroy: Ringwraiths hope stores fortresses army east settlements it gardens hills Ring mine boats threat you whom blast enemies Orthanc which us them
clutch: Blindfold knees bundle Ring hearts staff me gem him box menace wood arm
overthrow: Morgoth Ring front staff Lord Captain Sauron Age wraiths you land spoil siege
cut: things me ridge another way dash pans piece light it mischief cords ﬁnger bonds path web turves Ring hundreds trees hairs you throat horde others knees thongs front clatter loop groves head them branches Tree
march: southwards lights line H lines Orcs north inwards slopes army bed roads ﬁgures nothing
waylay: Orcs me soldiery him evil men Road
leap: villain it roof riders staff slaves another him path way Dwarf
swam: boats
drag: themselves Sam Ring hook him them feet nothing
wash: themselves myself footprints mud it walls meal cloaks hands you himself
lie: sward shrubs dim ring hours arrows wall motionless times all years watchers darkness something Renowned this listening him slopes woods Gondor hope forest land carcases Fields friends leagues longing himself ground sense men you jewels stream torchlight force them ﬁrst body pale hemlock son bare Quest beams edge King herself shoulders part skeleton tree lets coomb stones house bones vale sword triumph it ravine shapes landings what road weapon crown valley tricks ORD hands Frodo space which lawn
shine: light things blacker shadows it fruit sun dim north clearing him ring you mail nothing
conceal: it which menace them matter
shun: folk Elves sunlight relations
kick: leg him Wormtongue tree you heels
bite: me feet him them hands
curse: Southrons ship name him warmth them feet you day sneakthief
expel: him
journey: countries southwards ways wards word River water whence
pain: eyes him
lower: voice it eyes him blade himself
worm: way
cry: man answer Barley eyes Lord quaking sword King Legolas Denethor trumpeters ship Aragorn Boromir slope fall Gollum hand Sam praise those Gimli speed weapon Pippin aghast Wormtongue words Frodo hands others Merry ´ Eomer rock name splendour
suggest: fancies plot idea kinship
understand: things warfare purpose plan hurts thing me speech any question it Denethor danger part himself Elf war power tale words you master all tongues which remainder this them
amuse: wickedness
hurt: themselves farewell Master eyes me us him itself swords them you master
abandon: defences Mountains captives it Guldur boats Gollum Council use
cast: boat Balrog spear thing sword place LAC carcases light Enemy selves it end coil earth himself treasure weapons hat shadows story ground arms cloaks gear Mordor you yourself themselves ´ raiment gaze dainty circle shadow stakes them hood
decide: things ﬁght me North top City Weathertop path nightfall what Hobbiton course dawn climb Frodo weather company Bree day
suit: them purpose me it
betray: it me us him them you whom himself
murder: Boromir him Sme´agol Orcs
report: house names purpose it me words them you some
gnaw: stone things it shins bones him rinds itself feet
endure: Wind perils her it riders company this him evil torment onset speech storm steadfast weariness hours Sun glance
wrung: story
interrupt: threats
track: footsteps him Gollum you Bilbo
daunt: her Strider me distance words you
hunt: things emissaries foes orcs Orcs us Snaga ’em him them sight
climb: blade window distance ridge gate paces stair time barrow Legolas shaft someone stairs ravine slope ponies side hills steps hundreds Stair ORD hands lane which rock bank him them refuge trees mountain
weep: them son beard us
whine: ORD corridor water us
cringe: touch us
rub: it eyes drowse shoulder them hands
remember: Winter things voice minstrels me bones sign alliance North speech Ufthak we torture stars bit blackness line it danger raindrop aught birds cup Paths nights Aragorn smell gift rhyme pillar vision anything words Galadriel Pu´kel master Danger Merry which view us this name him splendour them strength
stab: ﬂame him creature
treat: Merry Shadowfax names him Aragorn hobbit them you
exert: power
trouble: praise her Tirith village hearts me us darkness Eye him them you
hammer: it
melt: butter it gold Rings water path
weigh: Ring heart matter courage
damage: it
strike: bit road variety Sam west Ferry gong it thing me rock stream water him spark path them Frodo
consume: Rings him
harm: Ring you
gain: knowledge door victory wisdom respite power gates stair shelter wealth news summit
gaze: shape wells sign east manner
surprise: me him Wulf them you
spring: ﬁne imprint king paces stair pain sword heads arm it Sting himself hand trap side steps cloaks ORD Frodo orders themselves roof him branch them way
thrust: light ladder lane dread it Ring end staff curtain ﬂask brand them arm himself purse
trim: border
exhibit: them
listen: ponies method weather sword nonsense Lord harm tongue What them Frodo Oin you himself
lift: blade voice eyes staff foot thing Phial hobbit boughs sword heads Stone knife pans stone light leaf horn lids it clippings bed hand cloak hearts arms lump bars Pippin Frodo hands master vessels head Eowyn him branch them branches
breathe: basin wind word thing air them sigh
punish: you those
steer: course it them matter what
move: Men blow eyes air me curtain noise swords arm wheels it mischief path armies himself hand slit unrest Ring speed war story words you inch song torchlight him chair them
sell: leaf hole End it us ale anything What
buy: knowledge house it lives mill you
sing: ways wind eyes songs slender roots stars it Elves himself attention harp words ORD you lilies song us this him them
toast: birthday
warm: house fruit limbs him hands
approve: Gaffer Faramir
console: him
strap: packs belt
pile: packs ´ years heaps wind ice spears them carcases
creep: foot thing gate nigh edge ears ravine slope wood shapes sleeves attention yards ORD blacker nearer darkness him rooms
lock: him door me it
shoulder: packs
halt: man breath pace tracks shores hoods journey sword camp night terror furlong moment power straps sounds Pippin company him them nothing
adjust: straps
hoist: bag sail
talk: nonsense questions bell lot him secrets them news tune you what
disappear: Bywater fainter them themselves
hum: tune it
strip: blankets jacket me
bathe: feet hurts hands der
spend: life year years ground something night corner nights time days study day
pursue: band Balrog Rangers it Balchoth foes me Orcs host him torment them you whom
remind: me us him them ORD
sweep: them top Osgiliath it heed boats me us fumes him trees sword enemy pursuers heads
prevent: them
overshadow: road it ground them armies
remain: gasp journey ﬂoor spoil ambassadors it Elves mists shape hatred earth what himself side door chamber words Shire towers him them contrast nothing
describe: behaviour Ring which country what
unsettle: me
hinder: it questions me us him them
decay: wood
rest: watch greetings sleep steps us meal cup tales refuge you journey
teach: road strangers lesson peril it wisdom words them you rhyme
wait: light house moment it ambush story ground chorus gate chance Faramir Boromir news
fare: Ring you
bend: hand her it wards eyes swifter gaze bastion power head limbs him thither neck gap
hail: king him
overtake: man horses Saruman Orcs sun us him fortune Northerners horsetail them you some
lodge: you
thank: her Lady him buri them you
shorten: attack it rups days journey
stagger: arm what themselves
wrap: stone themselves it grey belt itself cries himself
steal: edge themselves it which slopes them
lean: it Ring Swordsman ORD paddles
form: ideas space conspiracy tunnel
picture: what horses
nod: head eyes heads
question: Legolas me Gildor us Aragorn you
doubt: herself foeman it valour Shire which tale you
fence: yourselves
advise: me us this him Gondor them you
protect: them you
insist: you
ponder: books letter this words everything truth
taste: water bitterness it
scramble: it banks rock bank way
wade: river stream
mend: matters nothing it
glimpse: river hill line lines ﬁgures mass hawks
recognize: voice son value name ring L English words
recollect: pony time
spur: sword forts horse
jump: waterfalls ponies it throat steps fun harm horse lantern
swing: door whip it waters dogs arms them legs
mix: yourself
miss: Wind another Hen friend cheerfulness it path chance Pippin you counsellors Gandalf which meal something him them Bilbo journey
’ve: shirt clothes it idea something Pippin bone notion sense job time guts pain
crack: it heaps walls bones
whip: ponies you
light: bit top side bay it ﬁres shaft lanterns windows clearing water passage them lamps
ride: man blade garrison thence fashion madness wind king son prisoners air matters me Lord north sign aﬁeld knights pain swords cloud yell borders ford pony Shadowfax light comfort line it friends leagues end Paths West path slope pursuers himself hand northwards road side star west ﬁres gladder foreboding sounds Pippin horse men reason ORD heart Road labour foam ´ newcomers warily whatever Elladan which Shire us song goods him horsetail them way captains Bilbo pool sky
swathe: pony shore
excuse: you me
back: waggon gaze
plant: saplings hands selves Ents it toes spears generations tree feet
scratch: head
step: it staff pace touch grasp crown Lady call bridge itself him times Du´nedain sword ferry way sustenance yard
tie: it rope knot him you
hurry: path bump doors enquiry evening Deep Bridge nothing
shroud: world windows sun River path
busy: themselves herself myself himself
heave: shadow bag bundle sigh
chase: tail Riders mountains
exchange: news glances
plan: haunts he assault
mind: you business glimpse
depend: Merry spies
face: southwards slit west it darkness something trouble task feathers
deny: pleasure it me kinship this passage them
away: break
frighten: them me
search: northwards house it room lands ground us folk valley bodies them you Anduin
smell: it horses danger us him way grass blood
bent: lips course wind guile inwards head them
arch: tunnel
unlock: them door gate it
hem: them Orcs
burn: light all it Tree which part me ground houses snow him Phial ﬁerce bodies them heart carcases himself
plod: way hill
sink: nearer smoke pace shaft song head roads arrow ORD
ﬂow: mouths west Loudwater sail dominion
rise: mounds voice eyes counsel air cone valleys wits Sun cushions oaths light noon yells cliffs overﬂow it cup Aragorn battlement feet landings backs himself hill hand northwards peril moment wall sun deal arms shadowy Frodo miles throat knees desert horns song chorus bank table slopes stream him amount days mill them Company
cheer: ORD heart loneliness us
yield: man her unfought penny evil bag Tower them way himself
head: southwards course
ﬁle: ORD
overwhelm: him it
gape: them wall
overpower: him
stammer: things me
struggle: hand gasp jaws Ring him mind ORD himself
grip: hand weapons Sam arms him shoulder hilts
haul: him door it
heap: These
kindle: light face eyes ﬂurry fern devilry heart grass
squeeze: hole eyes me limbs him
singe: Road nonsense song
tuck: roots
crush: hull leaf lilies him cast them news
freeze: it marrow bones heart blood
behave: hisself himself
arouse: cries words
smite: side King hills it blow bearer Messenger eyes roof thing bridge him stair timbers iron heart you some
wind: lights it H bridge way
stalk: glimpse bare song line
ripple: shoulders
clap: them hands hand
refresh: yourselves dell company them you
clean: hands knife
comb: hair tangles
clear: street table necks land mess sight
grasp: sword line it candle rocks himself
stir: wind it eyes which hearts cloaks evil him anything them strength whom
disturb: Men dust surface me peace him dream plans slumber nothing
scrape: window quiver
drown: wits way Sting him
turf: all
screen: them line travellers
loom: road line peaks nearer wall Lord rampart shadow Mountain fathoms
broaden: leaves
waken: man light singing dream words Frodo
wake: notes fear master eyes sun us folk Man him anything you himself sky
delay: which me passage them way
ward: rain it
ﬂowe: them torrents valley candle workmen ORD
pay: tribute pence attention it gold master heed visit Pimple everyone loss some price
wag: head
spin: Ring snares
vanish: southwards road Silverlode Ring thing hearts slopes trail glimpse way hill
lend: it horses speed glass him trinket
prompt: him
check: boats counsel exclamation enemy steeds
stare: ﬂame him gate sink
slant: hill
dismount: them Merry ponies ground sword
clothe: them spikes themselves all her peaks wells us meal call him beggar hammers strangers sides mantle
ﬂye: them north
hasten: road slope passage news feet
recall: them counsel hosts him thoughts Ents you nothing
bow: her friends keys eyes head knee times words them device backs heads himself nothing
mount: pony ponies it lines him horse yell
stretch: hand lake themselves breath region gleam arms Muil courts them legs himself
crown: battlement him eastwards
provide: year reversal it hood word breakfast them way information
shrank: stones
harden: hearts him
rail: warmth
hunger: which
round: me curtain it ring neck wood feet Whitwell west guards necks master us something head candle him corner lip them
waver: nearer ground wind
fight: battles nearer defeat ﬁght war lands battle gift sword wars himself hold
resolve: sword Mordor rearguard Sauron
ﬂung: themselves villain it decisions rings height him shout strip them himself hood
fade: eaves it motionless sun glint way
sniff: danger air time it
bid: farewell those me us dearer him them you dwell
scatter: assault it ashes Rohirrim cushions them ORD
forge: hand Men Ring smiths gates master
murmur: voice n’t words some tunes
stride: foot pace horse slope shapes
land: ourselves Sauron them borders grass
quicken: tune pace
gallop: ponies wains it
rut: signs
guide: themselves woodman it me us him them Frodo you Star
toss: hat something plumes head way brand
twinkle: distance
nestle: village
survive: triumph turmoils Battle it
refer: interest magician
pierce: hand them King clouds hat strength eye roof mists which him night moss keenness hedge heart throat sky
bar: road ´ door ridge doors gate gates way shutters
fetch: it herbs water Sun luggage him lantern
eye: them Strider times creature
imagine: punishment it which animals me houses name courts them cleaning
ﬁnde: crevices body houses
peer: party horses
join: rebels picnic forces Hill water Aragorn Loudwater revel Silverlode guards Stoors regiments others enemies song company him party them mess
bob: travellers
tap: forehead
house: you
ring: gong bell clatter horns hour mockery him pain them trees others
homelike: misgivings
hover: them
care: this her company
duce: newcomers
rouse: Sam Gimli it himself embers Orcs deal touch folk him them companions movement Dwarf master
ﬁtte: him hoops
invite: Frodo
clasp: hand stone side it Ring belt Arrow master
venture: form Master visit Sauron time secrets journey
hesitate: visit Uglu´k master
brew: him beer devilry
dance: tail
prance: tail
doze: mug
neigh: bits
champ: bits
squeak: neek tune
bundle: him
whisper: he deal this tales stillness
assure: you
puff: embers
satisfy: rogue innards me
greet: friends Eomer us him them you
determine: hints assault form
escape: skill vigilance air gleam Sun journey it teeth water thither Umbar himself sight horsemen you net us gibbet shadow visitor him them strength way nets
clench: hand arms
reply: eyes
’m: me bones another hobbit grey orders
jog: memory
ﬁts: you
value: skin which END
’re: Mountain Baggins you
roast: him fool
subside: Strider
penetrate: disguise
gleam: side wings ORD enemy feet movement
count: ´ years things foeman Saruman names son leagues company hours days way heads journey
hire: them rufﬁans
afford: comfort host time it
rout: Bob
prove: arrow swifter climb faith king matters company foundation lord truce bony comrade enemy way heritage ruin
bolt: him corners
chew: apple something What
hit: head what square me
camp: feet
dive: banks manwise
hug: him bundle banks
defend: city Osgiliath themselves hills it us lives you
translate: word names it
observe: departure year enemies those them
low: crown
blame: him you part
examine: ground tracks it
scorch: ﬂames
realize: danger
trample: Forlong ground it
perceive: unrest roofs purpose her ﬁnger designs me EL signs mind them heart ness
wield: them years spear sword it tools men ring hammers blade brand dominion
berry: skill
cern: us
heal: Merry Elrond herself friends duties hurts swords feet heart grief nothing
release: hand sword her it prisoners me water him torment them you
fate: them marvels burden
aid: it Elves which me us him them you
behold: things years visions Tirith peril her it combat me shores him hobbit beauty Tree dancing
befell: them Umbar you
part: them man him
rescue: her Shire Beren me Elrohir master
slay: boar beasts assault ﬂed Fram me beast land it orc VI arrow arrows you Wolf themselves warrior Eomer leader him drake Trolls them Bard
wed: hand Morwen Finduilas Lothı´riel Celebrı´an daughter whom
encircle: them foes townlands
kneel: body cloak it corslet sword cloth
subdue: him
reproach: himself
obey: fellows him desire command
divide: loa those forces part valley Mordor
judge: footprints it hearts him you what
advance: miles him star
beset: you it
dig: grave Row something Gaffer pits trees
munch: lembas wafer it
mumble: bone
mutter: pikestaff something Pippin time words them Frodo
point: stone name those north
jingle: feet
beckon: them bushes
withdraw: them gaze himself
risk: light peril tale anything lighting
urge: attack legs him horse Rivendell them you
disquiet: him
persuade: Elrond me him horse you
awake: them what
hobble: them
rein: horse
robe: hoods all wheel
brandish: sword scimitars Sting
labour: cleave it fault wealth men way
cure: you us
bury: inwards them king Du´nedain
bore: which hole
torment: Frodo him you us
ﬂy: waterfalls Lord
n’t: courage bridle
smile: them him hers
sleep: Sam it Ring thing sustenance daylight night debate time words them grief you stars
hurl: themselves horses wards him them hands himself
whistle: head tune corridor stones
stroke: end ﬂanks it
congratulate: you
rival: Boromir fathers her
place: hands you himself myself
got: him it
polish: light it
drench: him walls
armour: him
arise: all her wind hearts towers men ears them himself nothing
tarry: him
sag: him
yearn: ﬂame
snort: him Bilbo
merrymake: business
encompass: them
present: arrow it him sword yourself
delve: passages fear wall us tale ORD places
perish: king kings doors
sweeten: it
crave: advice Surety
trace: Ring device copy
achieve: victory end what arms
abode: Ithil
outnumber: them itself enemies
ally: them itself
ﬁght: Mordor Enemy praise
treasure: heirs
trodden: plains paths
scowl: names teeth
recount: adventure all
omit: riddle
sufﬁce: assault heir
overheard: him
suade: us
declare: doom Ring plans devices what himself
cheat: him you us master
lull: words
misgave: me
double: heart
despair: him journey
forsook: wisdom Twilight chase earth borders
permit: those cloak it Ring foot Tirith me us lands strand him instruction them you brawls
commit: promise rule kingship
loseth: shape
deem: it which them unripe himself
tread: it which Paths ﬂowers path
tame: it shieldmaiden him whom lack
lengthen: remnants tale years
tremble: quiver him ears stroke jets
rue: exchange it
smote: pursuers heart captain
waste: arrows time
enclose: valley edge
await: her onslaught it Master me us morning him onset you
weave: strangers hue
shimmer: hue
avail: you us
bide: time
commend: itself her
unmask: yourself
muster: strength force
deceive: armour him messenger you yourself
grieve: that it tidings me him Boromir you whom Bilbo
invade: victory Shire Eriador beds
abide: silence changes fog Eowyn Sun him rumour
comfort: captives it me us him you
embrace: Eomer him newcomer fellow
mistake: me
shiver: son foot eyes gates glint them
depart: kingship H me hope task dwellings
summon: courage all him Sauron them Council you captains
postpone: day
torture: hills
corrupt: heart
stem: tide
inherit: heirloom
forbid: west me power entry them you
thrive: meal
foresee: strength end it
reward: him you gift
envy: them Sam you
chain: me
worry: yourselves what
represent: kindreds clothes nasals things ations Peoples ea denoting fence folk ch consonants Star relationship
storm: camp Tower
glitter: Arise it
unwound: folds
pack: it
counsel: friends me us Ecthelion him prudence them you
leapt: blast clouds
furnish: Elrond Company
swish: tail
stow: them goods coil it
vow: dark beast
strengthen: heart host bridges
tumble: land
lament: them
wheel: themselves nearer birds arrows ward himself
traverse: land
spy: ways secrets them ﬁgures land
convey: nothing
snuff: air
overhear: him debate words
govern: city Hobbits storms Grey folk beast words them Gondor yourself
heat: toes water
revive: him vigour
rejoice: light
scoop: wind
doom: man feet yourselves
widen: outwards track
rear: hand cone height him heads fathoms
blind: him Company
tire: us
liken: Moria
encourage: them men me
shrivel: you
plunge: head level heart
retreat: Guldur chieftain power them refuge
wound: way themselves Orcs
frown: shoulders
veer: southwards course
dam: valley
encumber: way
burst: them missiles likeness it
fumble: them
unlade: packs
sort: goods
shatter: them
writhe: mouth weapon doors
unroll: blankets
huddle: corner bodies himself
oppress: him loneliness
branch: spikes passages
plunder: themselves Moria
covet: edition it
tarnish: dim
stumble: balance leg bank stair pile shapes run
crook: scimitars
wellforge: it
shoot: man sword it ﬁnger me him rain arrow others arrows glance you gunwale
block: light door end rock what base
wedge: it
slam: it
fell: people him serpent trees thrust
sound: road esquire horns trumpets MAN you mufﬂed others
descend: ﬂight year river ﬂights Gollum way
skewer: boar me
slope: bed aisle archway waste
uphold: roof
span: chasm Bridge
capture: comrade Hall Sauron foal
yell: gangways arrows Sting Gondor
pour: sides overﬂow gangways waters liquid tale men them arrows ﬁlth
sud-: boats itself
spread: thence pavilion shape ORD cloaks itself ears area hands Anduin ruin
sway: pace
lash: hand cloaks whip
yawn: archway gaze
gird: ourselves
undervalue: it
chance: Galadriel it
veil: light feet towers ORD
scale: which mountains skirts bank
starlight: River
overhang: end stream
uncover: lamps lamp
lug: blankets gear
untie: legs ropes string
sling: them it
blindfold: eyes you
oppose: them him
rumour: light Enemy which
distrust: Moon silence world
howl: world
please: him you us names
strive: powers
account: man themselves it king kings
gandalf: Grey
blush: head
interpret: them songs
shift: trees
shade: road
will: it
diminish: fancies it
illumine: her
fort: him
moor: boats
delight: them which you remnants
accustom: yourselves
dazzle: eyes
dwell: her tire it nigh elanor rival days speech Cı´rdan
twine: elanor
draweth: nigh
lighten: heart
pin: him brooch
sprinkle: earth
linte¨: pella
yulma: enquantuva
reﬁll: cup
uplift: hands
blast: region breaches
harbour: them eyes
lurk: trail
grab: wrist leg arms blanket gunwale
pucker: brows
descry: tower desert spot arm pinnacles
sigh: hand Legolas eyes darkness gaze head him nothing
dismay: enemies
pop: Moon
wax: R sky
earn: which reward
jut: way
cower: hearts Frodo stillness
wet: toes beards
feed: springs me despair stream devilry armies grass
contrive: Merry Enemy it which them
restrain: themselves lips wrath him thoughts himself
cup: chin
suffer: man changes these defeat me rival harm torment loss doubt himself This
ﬂock: hosts
pardon: foolishness it Easterlings words you
misunderstand: me
anger: companions me us
curl: land fruit rainbow arms
nail: him
appoint: companions him Elrond
ﬂe: selves teeth rebels bolt resistance them
screw: himself
scare: them Frodo
upset: boat
rush: it packages sky
ﬁshe: packet packages
empty: folk boat land
race: slope
slain: Orcs
dishonour: bones
despoil: them all
array: Boromir feast Legolas it
row: sward Anduin
doth: dwell
survey: lands morning ground them lawn
tramp: slot
mar: which speech
glimmer: light scent
grudge: chance halt game delay
grind: corn teeth
tear: ear it darkness bandage them feet beard himself
match: them strength
thwart: me
thence: leagues
misgive: me
overtook: Orcs
desert: tower it friends me him you Ithilien holes
sight: them
constrain: man glass
lessen: hope it
lain: motionless river
trick: eyes
tickle: you
avenge: it folk him father death himself
snick: arm
knot: it
growl: voice Gorbag
unclasp: brooch
famish: creature
snarl: Grishna´kh
legge: it
bruise: ear grip
grate: ear
unreste: backs
jeered: Isengarders What
aston-: Pippin
gild: helmets
disobey: command
post: watchers archers
crawl: body steps Orcs them himself
hiss: he goblin words everything himself
aim: hand blow
arrive: besiegers
stamp: feet ashes it
clamber: water caves
buck: hunter
boar: ﬁghter
quiver: them branches
train: strangers
weed: strangers
e: water
lave: brow hands feet
reappear: them Dwarves
weather: it
repay: promise trust debt me
plot: war world Power ruin
blend: races
pronounce: malediction doom judgements Blommath
thump: hand
cool: myself
blossom: ORD
till: ﬁelds
honour: them commands memory
parch: mouths sun
unfold: leaf
perch: Pippin
strode: Pippin
bottle: it
splash: feet clouds ears
split: stone walls
wither: man fruit
bafﬂe: Ranger
puzzle: him me words
scan: ledges
ﬁt: you words it
hood: hands hat gauntlets
strove: part
elude: him enemies
darken: hearts heart him
threaten: Men knight Gondor them borders you death
spill: stream it
ﬁll: it me valley heart pans pipes
ease: heart sense
measure: it
stray: me ruin
ﬂoat: me
nuzzle: nostrils
caress: brow him it
sunder: land Sea
prevail: Guldur heir
dim: ﬁgures
cleave: roof road
rebel: death
clash: weapons spear
displease: him you father
bewitch: King you
lick: roof lips knife teeth
undo: ORD belt
pray: things you
haunt: steps Forest
bare: heads teeth
deﬁe: voice
reserve: sword
proffer: it
entrust: people
arm: folk
loose: folk hearts arrow
repair: wall haven injuries
sear: air ﬂash
trip: him
rally: them
ﬂame: them sword
glean: arrow
crash: them him words
clang: door
withstand: edge him passage them siege numbers
clove: way path
reel: spear
scream: spear Gondor
foretell: which manner time
delude: Saruman
mourn: earth
curtain: ﬁne
pillare: courts
unmove: loveliness
mine: caves
display: it chambers tokens serpent tree
ﬂew: birds grasp
boil: waters
pasture: droves
trail: caves
pave: lines
fashion: builders
smooth: Ring hair
splinter: heaps
tere: heaps
witness: meeting
practise: which
select: servants
broil: them
starve: you
seat: themselves
wreathe: slopes yourselves
loosen: hand belt sword swords
shudder: strength himself
last: victory coat nights
dream: dream
infuriate: them
poison: them bark darts
tione: them
reduce: part errors loss
spot: him me us
roam: deal
stuff: cloaks pouch
loiter: Treebeard
master: stone horses it measure men them you Stone himself
digest: it
blot: everything drizzle
re-ﬁlle: pipe
slap: thighs
tilt: you
gainsaid: voice
conquer: west Harad it him men Mountain whom
reject: them us commands terms
deﬁed: them eyes
coil: itself it
endeavour: you
proﬁt: us
affect: Ring Quenya lot
dismiss: him work
surrender: it staff sceptre his you freedom
merit: them
purchase: sizes
undertake: errantries labour
ruin: them darkness yours
tackle: Strider
fathom: which
tiptoe: stone
idiotic: fool
snatch: torch time
unite: realm
wrench: sword eyes Stone it
gash: ravine
tighten: belt it
swallow: bones mouthful graves sky
steady: himself it
brace: yard himself
brood: which
curve: road
stiffen: Sam
rissk: neck
pity: slaves him sorrow them you
suck: blood teeth
shriek: Gollum
ﬂat: feet
prise: them
twist: them words it
pause: it moment eyes us head challenge them Gollum
swear: service oath him promise what Him
pat: it
ﬂinch: touch
rebuke: him
suspect: him
spit: him arms
prod: Gollum
uncurl: movement
twitch: movement
nurse: limbs it
kiss: foreheads hand her it brow Pippin them forehead
dratte: creature
retrace: steps
gladden: hearts
complain: nothing
vomit: ﬁlth
deﬁle: ORD
disease: ORD
thread: way
purpose: Mordor Jewels
mantle: sides
imply: measure
abash: him daughter
terriﬁe: him
grovel: words
unnerve: him
Isildur: son
cling: Gollum knees
stump: round
overhung: banks
relish: idea it
drank: ﬁll bowls it
paw: Gollum
cook: taters deal
whet: it
carve: stone letters image hills you
choke: you me
nigh: Shire
stew: What
neglect: which
truss: packs
halﬂe: folk
charm: him
mask: gap gauntlets
enlarge: him language
smash: ﬁgure
clung: ﬁgure
appease: Faramir
snare: orc
ﬂoate: sides it
durst: it
goest: thou
breed: them peace brood Power
reverence: him
ambush: arrows
glint: waters
blink: them
twas: trunk
whisk: trunk
fancy: nothing
irk: Boromir
rekindle: hearts it
compound: elixirs
recruit: strength
cede: ﬁelds
pluck: courage shaft
quiet: suspicions
misdoubt: Elves
drownd: yourself
ﬂushe: scarlet
boast: dom
marvel: that it speed companions heart midst
amend: it
cost: lives him me pains
grant: wanderer grace Ea¨rnil it
grunt: way Sam Gorbag
entreat: him
reverse: judgement
re: tales it
-: tales it
bestir: themselves
plait: thongs
squeal: Blindfold
squirm: Blindfold
claw: him ashes
maim: shape it
illuminate: nothing
revolve: head
fascinate: him
discern: pinnacles
click: tongue
sparkle: centre
afﬂicte: them
spre: eyes
Sme´agol: her
worship: him her Sauron
ﬁxe: intent
gasp: chance breath
slash: blade hand bottle
drabble: spittle
sting: him
chafe: feet
compose: body
fold: hands cloak
distort: ﬁgures
skin: you body
misjudge: distance
wilt: shelter
mingle: it men Speech
hedge: them tombs
dome: tombs
drip: tree
falter: Pippin herself
belie: man her
link: hill
rack: me
consent: you
ﬂappe: standards
tug: standards
wain: lines
skirt: foothills hills
assault: which mountains
assign: company
rid: ale
salute: him
obscure: cloud contrast
sheathe: sword Sting
kindre: ASS counsel
depress: words
proclaim: title enemies
mone: ORD Men
ﬂashe: sword sable Denethor
adventure: it
throng: host
unfurl: standard banner it
piece: words
loop: wards
dissuade: them him
paint: arrow
enshroud: son
fulﬁlle: them it Quest Oath
dole: order
man: walls
outrun: them
admit: Pippin
rend: earth
rent: air
pace: them courtyard
recke: nothing
straggle: shape
squat: earth
quail: head it
outpace: it
thunder: knights
roar: horsetail
wail: them purposeless
slacken: speed
founder: sword hull
ﬁghte: him
outstay: brood
marshal: which
brush: tears
numb: hand
knit: sinews
toll: alarm
act: him
rob: son me us him revenge
crackle: him
unabate: ﬂames
presume: it
ﬂuttere: wind
pitch: tents
bestow: her
tis: name
straightway: freshness
galenas: you
inform: son you
rot: times
outlast: you us
contest: fords
unheede: ﬂowers
deepen: shadow hearts darkness
whiten: foam lane
unveil: standard
regain: crown Ithilien Edoras it
crumble: rents shape
succour: people
harry: coasts Rohirrim
rejoin: Guard
waft: mists
shame: mercy
chill: them force
wrest: silmaril lands
establish: selves dwellings
rate: prisoner
recoil: tokens
slaver: him
ache: lights
shield: him
cow: me
pump: breath
knife: dung
throttle: him
rhyme: tunes
rummage: it
expose: them
hearten: you
belch: fume
replenish: bottle numbers
dry: mouth
mass: them
slunk: bush
stunt: bush
quarrel: Speech
mess: scent
shadow: rocks grass path
ﬂicke: whip
toil: end
complete: movement destruction hall duˆr Hall
rely: it
stint: himself
beheld: desert
espy: them
squander: strength
furl: ﬂame
pere: me
stink: thing
trudge: road
hurtle: southwards
inhabit: hill
outﬂy: it
well: wind
praise: them
outmatch: whom
tower: walls
engulf: world
stream: air
renew: attack it invasions Oath hunt
scorn: them pity
knelt: Aragorn
stricken: head
uproot: it
cloak: Elladan
alight: hand
conﬁrm: words
lade: you
accurse: slayer
shed: cloaks
peep: cry
ﬂinche: it
arrest: you who
annoy: leader
own: sight
stomach: them
foul: which Water
trapesse: mountains
charge: rufﬁans
date: names
foot: bill
rang: horn
amble: time
stain: Shire
twang: word
marry: Cotton Eomund Vidumavi
resign: ofﬁce
indicate: points death addition
found: refuge Osgiliath realm dwarf
enrich: them people it
begrudge: choice
repent: name
usurp: sceptre
levy: tribute
humble: himself
succeed: son nephew father him
restore: Telcontar ofﬁce
bound: Glanduin
fortiﬁed: shore isle Hills;1 it
repel: enemy forces
revere: pleasure Du´nedain
ransom: Du´nedain it
foster: heirlooms
slew: him
rebuild: Anor Tower Dale
compel: overlordship
exceed: needs designs
besiege: Ithil Minas it
raid: coasts
sap: strength
avert: father
relinquish: realm royalty
single: Captain
swerve: him
trap: king Orcs
renounce: Ring lineage
exercise: power
never: war
pare: strokes
infest: orcs
vie: himself
mistrust: him others
plight: troth
overbear: grief
forbear: him
bloom: east
overrun: Steward
slaughter: Easterlings
submit: him
revile: king
reconquer: march
folcre: them
prosper: friendship
poke: beards
hack: body
ﬂinge: pieces
sack: strongholds
engage: company
brand: you
dart: leg
deprive: them
trafﬁcke: wealth
disperse: him
da´in: slew
swell: numbers
seduce: Eldar
extend: eastwards
support: you
retake: Umbar
r: brother
devastate: Minhiriath
debate: Rings
fortiﬁes: it
owyn: sister
cleanse: Guldur
rename: Lasgalen
ofﬁce: goods
repute: sea
occur: ´ memory
adhere: loa letters
intrude: deﬁcit
conclude: millennia
insert: day
cite: time
transcribe: bell
substitute: speakers
rembe,+: jewel
denote: letters
devise: sounds Sindar name Sauron
express: some abbreviations
merge: nasals
mislead: Frodo
ennoble: Du´nedain
ascribe: desire
dere: land
pervert: it
allege: whatever
inscribe: them
astonish: servants
anglicize: them
modernize: spellings
pushdug: glob
846–9: passim
miel: cf Lands
sire: names
apply: Star
elwe: White
eore: troop
fra´r: Fre´a
ril: Phial
rin: I
renan: Elves
926–9: slaves
ath: Mouth
888–92: passim
reforge: 276–7
whitfurrow: Whitwell
wing: beast
